##################################################
#.O..#OOOOO....#O..OOO.......OO...O.O..OOO.O.OOO.#
#.O..OOO....O....OO.OO.....O.....O...##..O#...OOO#
#O.........O.....#..O..#......#..#OO..........OOO#
#O.#.....O........OO...OOOO...#.OO..##O..OO.#..#O#
#........O.O......O...O..O.....O#O...O.##.....#OO#
#OO........O...OO#OOO.........OOO..........OOOOOO#
#OO...........OO#OOOO..........O...#..#O.......OO#
#OO.O..O....#.#..#OOO.................#O........O#
#OO.#..#..#...O...OO..........................O.O#
##O.........OOO....OO....#......O.O.O............#
#O...O..O..OOO...OO..........O.O..OOO#..O.#.O#O..#
#O...#O.#.O..O...OOO..........O..........O..OOOOO#
#.O#..@...O.OOOO.#OOO.O..OOOO......O.....O...O#..#
##O..#.....O.......O#......O.OO.OO.OO....O##.OOO.#
#OOO.....O....#......OO...O..OOOO#......O....OOOO#
##..##...#OOO.#..O...#..O..#.O.O.O.....O#....OO#.#
#O..O.O.OO##O....O..O...................OOOO...#.#
#O..O..O..#.#.#.....O.....OO...OO.#O.O......#...O#
##.....O........OOO.OO#O.OO...O#OO.#..O...#......#
#O......#...OO..#...O#...O....OO##.O..........OOO#
#O......##O..O.......OOOO..OOO.....OO.O.....##.#.#
##......OO...OO....O.......#........OO#....O.....#
#OO..#..#OO#.O.O...........OOO.......#OO.......OO#
#..#O....O#.........O............#..O..OO........#
#.O#O........#......O........O.....OO#.O#........#
##.#O........O..O..##........#......OO#OO....OO..#
#...#...#.............OOO....#.O....OO##O.....#O.#
#.OO........O........#O.O...O..O#O##.O.....#..O###
#OOO......OOO.OO.......OOOO.#..OOOOO...........O##
#.O#..#...OO......#....O....O....OO#...........OO#
#OOO......#.......O...#..........#.#...O#..O....O#
#.............OOOOOO.............O#O..O.O#..O..O##
#OO...............#.O......O.....OO.OO..O...#...##
#O..#....OO..O.O..#OO.O..##.....O...O.......OO..O#
#OO......#O..O.OOOO.O.O...O..#......O....OO..O..##
#OO........#..OO.O#O.............OOO#O.O##...O..O#
#OOO.......#.O.O..OO...O.#......O..#...#OO...O.OO#
#.#O.....#.O.#.O#....O......OOOOO....#OOOO...O##.#
#...#.O.......OOO#.O..##O..O...#O.#OO##.O.....O..#
#O.....O.......O#.OOOO....#..O...#OO.OO#O......#.#
#O..O.......O#.........OO.O..#O..O........#....OO#
#O....#O....OOO....#..OO....O.............#.....O#
#..#...#.............O#OOO.OOO.O......#O........##
##.#..#.O...O.....OOO....#.O.O...........#O..O..O#
#....#O.#...OOO.....O...............O...O#O...OOO#
#..........O..#.............#O....O#.#O.#.#...#O.#
#........OOO....O..............O..OOO...#OO....O.#
#OO.....OO#OOO.......O#OO.#O.O##OOOOO.O.......OOO#
##################################################
